90
0
13
5
3
2
0
+P+B+P+C+
PBVBVBPBV
+P+C+P+V+
VBVBBBVBP
+P+P+P+V+
