90
0
13
5
3
0
1
+P+C+P+P+
PBPBCBPBC
+P+P+C+P+
CBPBPBPBP
+P+P+C+P+
