90
0
13
5
3
1
1
+P+C+C+C+
PBPBVBVBV
+P+C+V+P+
VBPBPBPBP
+P+P+V+P+
