35
11
84
10
9
2
1
+P+P+B+P+B+P+P+B+B+
PBVBPBBBPBPBPBBBPBP
+P+P+P+P+B+P+P+P+P+
BBVBPBPBPBPBBBPBBBP
+P+P+B+B+P+P+V+P+B+
CBBBVBBBVBBBPBBBPBB
+P+P+P+B+P+B+B+P+P+
BBBBVBBBPBPBBBPBVBB
+P+B+P+V+B+P+B+P+P+
PBPBBBPBBBVBPBBBPBP
+P+P+P+B+B+P+P+P+B+
PBBBBBPBPBVBBBVBBBP
+P+B+V+P+P+P+P+B+P+
BBBBPBPBBBVBBBPBBBP
+P+P+P+P+P+B+P+B+P+
PBPBBBVBPBBBPBBBPBP
+B+B+P+P+P+C+B+P+B+
