20
0
349
20
18
3
1
+P+P+B+P+B+P+P+B+B+P+P+P+B+P+B+P+P+B+B+
PBBBPBBBPBPBPBBBPBPBPBBBPBBBPBPBPBBBPBP
+P+P+P+P+B+P+P+P+P+P+P+P+P+P+B+P+P+P+P+
VBBBPBPBPBPBBBPBBBBBBBBBPBBBPBPBBBPBBBV
+P+P+B+B+P+P+B+C+B+B+P+P+B+B+P+P+B+P+B+
PBBBBBBBPBBBPBBBPBBBPBBBVBBBPBBBPBBBPBB
+P+P+P+B+P+B+B+P+P+P+P+P+P+B+P+B+B+P+P+
BBVBBBBBPBPBBBPBBBBBBBBBVBBBPBPBBBPBBBV
+P+B+P+B+B+P+B+P+P+P+P+B+P+B+B+P+B+P+P+
PBPBBBPBBBPBPBBBPBPBPBPBBBPBBBPBPBBBPBC
+P+P+P+B+B+P+P+P+B+P+P+P+P+B+B+P+P+P+B+
PBVBBBPBPBBBBBBBBBPBPBBBBBPBPBBBBBBBBBP
+P+V+B+P+P+P+P+B+P+B+P+V+B+P+P+P+P+B+P+
BBBBPBPBBBPBBBPBBBPBBBBBPBPBBBPBBBPBBBP
+P+P+P+P+P+B+P+B+P+P+P+P+P+P+P+B+P+B+P+
PBPBBBBBPBBBPBBBPBPBPBPBBBBBPBBBPBBBPBP
+B+V+P+P+P+B+B+P+B+P+B+V+P+P+P+B+B+P+B+
PBBBBBPBPBBBPBBBPBBBBBPBBBBBBBBBBBPBBBP
+P+P+V+P+B+P+P+B+B+P+P+P+B+P+B+P+P+B+B+
PBBBPBBBPBPBPBBBPBPBPBBBPBBBPBPBPBBBPBP
+P+P+P+P+B+P+P+P+P+P+P+P+P+P+B+P+P+P+P+
BBBBPBBBPBPBBBPBBBPBBBBBPBBBPBPBBBPBBBB
+P+P+V+B+P+P+B+P+B+B+P+P+B+B+P+P+B+P+B+
PBBBBBVBPBBBPBBBPBBBPBBBVBPBPBBBPBBBPBB
+P+P+P+B+P+B+B+P+P+P+P+P+P+B+P+B+B+P+P+
BBBBVBBBPBPBBBPBBBVBBBBBBBBBPBPBBBPBBBB
+P+B+P+B+B+P+B+P+P+P+P+B+P+B+B+P+B+P+P+
PBPBBBPBBBPBPBBBPBPBPBPBBBPBBBPBPBBBPBP
+P+P+P+B+B+P+P+P+B+P+P+P+P+B+B+P+P+P+B+
PBBBBBPBPBBBBBVBBBPBPBBBVBPBPBBBVBBBBBP
+P+B+V+P+P+P+P+B+P+B+P+B+B+P+P+P+P+B+P+
BBBBPBPBBBPBBBPBBBPBBBBBPBPBBBPBBBPBBBP
+P+P+P+P+P+B+P+V+P+P+P+P+P+P+P+B+P+B+P+
PBPBBBVBPBBBPBBBPBPBPBPBBBBBPBBBPBBBPBP
+B+B+P+P+P+B+B+P+B+P+B+B+P+P+P+B+B+P+B+
